wwwwwwwwwwwwwwwwwwwwwww
w.....................w
w.....................w
wnm.m.m.m.m.m.m.m.m.m.w
wm.m.m.m.m.m.m.m.m.m.nw
wnm.m.m.m.m.m.m.m.m.m.w
wm.m.m.m.m.m.m.m.m.m.nw
wb.b.b.m.m.nm.m.b.b.b.w
w.....................w
w.....................w
w.....................w
w.....................w
w.....................w
w.....................w
w.....................w
w.....................w
w.....................w
w.....................w
w.........A...........w
w.....................w