wwwwwwwwwwwwwwwwwwwwwww
w.....................w
w.....................w
wnt.t.m.m.....m.m.t.t.w
wm.m.m.m.m...m.m.m.m.nw
wnm.m.m.m.m.m.m.m.m.m.w
wm.m.m.m.m.m.m.m.m.m.nw
wt.t.t.t.t.nt.t.t.t.t.w
w.....................w
w.....................w
w.....................w
w.....................w
w.....................w
w.....................w
w.....................w
w.....................w
w.....................w
w.....................w
w..........A..........w
w.....................w