wwwwwwwwwwwwwwwwwwwwwwwwwwww
w00w.....................00w
w00w...........1..........0w
w00w.........1....1........w
w.ww......1.....1....1.....w
w............1.....1.......w
w...............1..........w
w.B....................wwwww
w..A...................w000w
w0......................000w
wwwwwwwwwwwwwwwwwwwwwwwwwwww