wwwwwwwwwwwwwwwwwwwwwwwwwww
w00w...................w00w
w00....A...........B....00w
w..1.wwwwww.....wwwwww..1.w
w0.........1...1.........0w
w0...........1...........0w
w0.........wwwww.........0w
wwwww.................wwwww
w0.......0.0.0.0.0.......0w
wwwwwwwwwwwwwwwwwwwwwwwwwww