wwwwwwwwwwwwwwwwwwwwwwwwwwww
w.w0w.........0........w0w.w
w...........wwwww..........w
w00w....................w00w
w00w......1...1...1.....w00w
w00w..........w.........w00w
w0............w......w....0w
w.............w......ww....w
w.........A.......B........w
w.w0w..1......0.....1..w0w.w
wwwwwwwwwwwwwwwwwwwwwwwwwwww