wwwwwwwwwwwwwwwwwww
w.................w
w.....0.....4.....w
w.....1.....5.....w
w...A....+....B...w
w.....2.....6.....w
w.....3.....7.....w
w.................w
wwwwwwwwwwwwwwwwwww