wwwwwwwwwwwwwww
wa_____B______w
w1____________w
w___w_________w
wwwww______w__w
w__________w__w
w_____www_____w
w__w__________w
w__w______wwwww
w_________w__0w
w______A_____bw
wwwwwwwwwwwwwww