wwwwwwwwwwwwwwwwwwwwww
w+w................w-w
w+..................-w
w+..................-w
w+..................-w
w+wA..............Bw-w
w+.........o........-w
w+w................w-w
w+..................-w
w+..................-w
w+..................-w
w+w................w-w
wwwwwwwwwwwwwwwwwwwwww