wwwwwwwwwww
w.w.......w
w.....w...w
tu........w
tAr......ww
td........w
t1..w.....e
tB2..w....w
t3........w
t.......w.w
ww........w
w......w..w
wwwwwwwwwww