wwwwwwwwwwww
w..........w
w...ww.....w
w.t........w
w.t........e
w.t.......ww
w...w......w
w1...w....uw
tB2......lAt
tttttttttttt