wwttttttttttww
w...lAr.0B2..w
w...wd...3...w
w..........w.w
w............w
w.....w......w
w............w
w.w.........ww
w..w.....w...w
w.......w....w
w.w..........w
w.........w..w
wwtttttettttww