twwwwwwwwwwwwwww
t..............w
t...tt....w....w
t..w..........uw
t.w......w...lAt
t........w....tt
t...w..........e
t.........w...tt
t.w.....ww...0Bt
t..w..........3w
t...tt....w....w
t..............w
twwwwwwwwwwwwwww