wwwwwwwwwww
wnnnnnnnnnw
wn222p111nw
wn222p1A1nw
wn222p111nw
wncccccccnw
wn111p222nw
wn111p2B2nw
wn111p222nw
wnnnnnnnnnw
wwwwwwwwwww