....A....
....5530.
....r.r0p
a03.430.2
..43.r...
...402...