wwwwwwwww
wa______w
w_______w
w____ww_w
w_______w
w___p___w
w_______w
w_ww____w
w______0w
w_A_____w
wwwwwwwww