wwwwwwwwwwwwwwwwwww
w.........b.......w
wttbtwwwwwwwwtttbtw
w......t..t.......w
w......b.etA......w
w......t..t.......w
wttbtwwwwwwwwtbtttw
w.........t.......w
wwwwwwwwwwwwwwwwwww