wwwwwwwwwwwwwwwwwwww
w........hhh.......w
w..................w
w.....rrrr.r.......w
w..................w
w.........r........w
w..n.............A.w
w..................w
w.........r........w
w..................w
w........r.rrrr....w
w..................w
w........hhh.......w
wwwwwwwwwwwwwwwwwwww
