wwwwwwwwwwwwwwwwwwww
w........A.........w
w............h.....w
w...r.r..r...rr....w
w..h...........rrrrw
w...rrr...rr.......w
w.....h.....r......w
w..rr..rr.rr..rr.h.w
w...r......h.......w
w.rrr.rr..r.rr.....w
w...h..............w
w..r.r.r...rrrrr...w
w........n.........w
wwwwwwwwwwwwwwwwwwww
