twwwwwwwwwwwwwww
t..............w
t...tt....w....w
t..w..........uw
t.w......w...lAt
t........w....tt
t...w..........e
t.........w....t
t.w.....ww.....t
t..w...........w
t...tt....w....w
t..............w
twwwwwwwwwwwwwww