wwttttttttttww
w...lAr......w
w...wd.......w
w..........w.w
w............w
w.....w......w
w............w
w.w.........ww
w..w.....w...w
w.......w....w
w.w..........w
w.........w..w
wwtttttettttww